111111111111111
1C1010C111C0011
1000001S0011011
1001111E1010011
100000111011001
101110100010001
100C100010001C1
111111111111111
