1111111111
1C11011E11
10000010C1
1010000011
1C101S10C1
1111111111
