11111111111
1C00000C1S1
10111010101
101E1010101
10001C00001
11111111111
