1111111
1C1ES01
1011101
1000001
1111111
